1111111111111
1P00000000001
1000000000001
100000E000001
100000C000011
1111111111111
