11111111111111111111111111111111111111111
100C000E0P0000000000000000000C00000000001
10000000000000000000000000000000000000001
10000000000000000000000000000000000000001
10000000000000000E00000000000000000000001
10000000000000000000000000000000000000001
100000000000000000000000000000000C0000001
1000000000000000000E000000000000000000001
10000000000000000000000000000000000000001
10000000000000000000000000000000000000001
10000000000000000000000000000000000000001
1000000C0000000000E0000000000000C00000001
10000000000000000000000000000000000000001
11111111000000000000000000000000011111111
11111111000000000000000001111100011111111
11111111000000000000000000000000011111111
100C000E000000000000000000000000000000001
10000000000000000000000000000000000000001
10000000000000000000000000000000000000001
10000000000000000E00000000000000000000001
10000000000000000000000000000000000000001
100000000000000000000000000000000C0000001
1000000000000000000E000000000000000000001
10000000000000000000000000000000000000001
10000000000000000000000000000000000000001
10000000000000000000000000000000000000001
1000000C0000000000E0000000000000C00000001
100000000000000000000000000000000000000E1
11111111111111111111111111111111111111111
11111111111111111111111111111111111111111
