11111111111
100P0010001
10101010101
100E000C001
1000000C001
11111111111