111111111111111111111111111
1000P0000001C00010001000101
100E00000001111000101110001
100001111111001111100010001
100010000000000000101010001
100010000000000000001010001
100110001111111111101010001
100000000000000000001010001
100011111000011000001000001
100000011111111111101000001
100000000000000000000000001
100000000000000C00000000001
100000000000000000000000001
100E0000000000000C000000001
111111111111111111111111111