11111111111111111111
10000000W0000P000C11
1000000000E000000001
11111111111111111111