1111111111111111111111111111111111
1E000000000W0C000000C00W0C00000001
1010010100100100101001100100110101
10100100101101W00W1001110100010101
1P00001W0C0C00000000000000000W00C1
1111111111111111111111111111111111