11111111111111111111
1000C00000000P000C11
1000000000E000000001
11111111111111111111