111111111111111
1000000P0000001
100000000000001
100000000000001
100000000000001
10000EE00000001
100000000C0C001
111111111111111